~ . . . % % % . . . . . . . . % 
. . . % % % . . . . . . . . . . 
. % % % % . . . . . . . . . . . 
. % % % % . . . . . . . . . . . 
% % % % . . . . . . . . . . . . 
% % % % . . ~ . . . . . . . . . 
% % % % . . . . . . . . . . . ~ 
. % % % . . . . . . . ~ . . . . 
. . % . . . . . . . . . . . . . 
. . . . . . . . . . . . . . . . 
~ . . . . . . . . . . . . . . . 
. ~ . . . . . . . . . . . . . . 
. . . . ~ . . . . . . . . . . . 
. . . . . . . . . . . ~ . . . . 
% . . . . . . . . . . . . . . . 
% . . . . . . . . . . . . . . . 
