~ . . . % % % % . . . ~ . . . . 
. . . % % % . . . . ~ . . . . . 
. . % % % . . . . ~ . . . . . . 
. % % % . . . . ~ . . . . . . . 
% % % % . . . . . . . . . . . . 
% % % % . . . . . . . . . . . . 
% % % % . . . . . . . . . ~ . ~ 
. % % % . . . . . . . . . . . . 
. . % . . . . . . . . ~ . . . . 
. . . . . ~ . . . . . ~ . . . . 
~ . . . . . . . . . . ~ . . . . 
. ~ . . . . . . . . . ~ . . . . 
. . . . ~ . . . . . . . . . . . 
. . . . . . . . . . . . . . . . 
% . . . . . . . . . . . ~ . . . 
% . . . . . . . . . . . . ~ . . 
