-----------------          ----------
|               |          |        |
|       *       +#######   |        |
------+----------      ####+        |
                           ----------
