####################################
#..................*...............#
#..1...............................#
#.............................7....#
#..................................#
#..........*.......................#
#..................................#
#..................................#
#.....4............................#
#...........................9......#
#..................................#
#..................................#
####################################
