#+#############++
+...............+          ##########
#...............+=======   #........#                     #######
#...............#      =   #...>....#                     #.....#
######+##########      ====+........+=====================+.....#
                           ###+######                     #.....#
                                                          #######
