-----------------          ----------
|...............|          |........|
|.......*.......+#######   |........|
------+----------      ####+........|
                           ----------
