#################          ##########
#...............#          #........#
#.......>.......+~~~~~~~   #........#
######+##########      ~~~~+........#
                           ##########
