 =
 =
 =
 =
#+#############++
+...............+          ##########
#...............+=======   #........#                     #######
#...............#      =   #...>....#                     #.....#
######+##########      ====+........+=====================+.....#
      =                    ###+######                     #.....#
      =                                                   #######
      =
      =
      =
      =
      =
      =
      =
      =
      =
      
