#+###############
#...............#          ##########
#......>........+=======   #........#                     #######
#...............#      =   #........#                     #.....#
######+##########      ====+........+=====================+.....#
      =                    ###+######                     #.....#
      =                                                   #######
      =
      =
      =
      =
      =
      =
      =
      =
      =
      
