 =
 =
 =
#+####
#...>#
#....#
#....#
#....#
#....#
######